111111111111
10000E111111
10C000000P01
111100000111
100000000001
100C00000111
111110000001
100000011001
111100000001
100001111111
111111111111