
111111111111
10000E111111
10C001000P01
111111111111
