
1111111
1P000E1
10C00E1
1111111
